 3 Hungarian Folksongs from the Czik District - Bela Bartok
 4 Pieces: No. 2. Autumn Night - Wanda Landowska
 American Beauty Rag - Joseph Lamb
 Caitlin-Chris Marshall
 Church of Trees - Liz Story
 Church of Trees - Liz Story Piano Sonata No. 14 "Moonlight": 2nd movement - Ludwig van Beethoven
 Clarinet Quintet: 3rd movement - Wolfgang Amadeus Mozart
 Concert Etude No. 1 - Agathe Grondahl
 Concerto Grosso No. 10 after Scarlatti - Charles Avison
 Concerto for Two Mandolins - Antonio Vivaldi
 Cosi fan tutte: Soave sia il vento - Wolfgang Amadeus Mozart
 Farewell to Stromness - Peter Maxwell Davies
 Folk Suite No. 3 - William Grant Still
 Four Waltzes - Johannes Brahms
 Glass Houses: No. 15 - Ann Southam
 I vow thee to my country - Gustav Holst
 Jeanie with the Light Brown Hair - Stephen Foster
 L'Arlesienne Suite No. 2: Farandole - Georges Bizet
 La Boite a Musique (Music Box) - Pierre Sancan
 Lakme: Flower Duet - Leo Delibes
 Les Baricades Misterieuses (Mysterious Barricades) - Francois Couperin
 Miniatures - William Grant Still
 Once in Royal David's City - Henry Gauntlett
 Piano Sonata No. 14 "Moonlight": 2nd movement - Ludwig van Beethoven
 Prelude and Fugue No. 5 - Dmitri Shostakovich
 Promenade (Walking the Dog) - George Gershwin
 Quintettino "La musica notturna di Madrid" - Luigi Boccherini
 Serenade No. 10 "Gran Partita": Minuet II - Wolfgang Amadeus Mozart
 Serenade on Country Dances - Jeno Takacs
 Silver Clouds Chasing the Moon - Ren Guang
 Suite No. 1: Fuga con Pajarillo - Aldemaro Romero
 The Garden of Cosmic Speculation: Garden of the Senses Suite - Michael Gandolfi
 The Maiden with the Daffodil - Arnold Bax
 The Musical Box - Anatol Liadov
 Violin Sonata - Wolfgang Amadeus Mozart
 Wanting Memories - Ysaye M. Barnwell
