 BEBO VALDEZ - SPECIAL DE BEBO
 CHEO FELICIANO - SALOME
 CHINO Y SU CONJUNTO MELAO - BARBARIDAD NAVIDEÑA
 CONJUNTO LIBRE - LIBRE Y SU SON
 CREACION 75 - COGELO SUAVE
 FACUNDO RIVERO - NI NA' NI NA'
 FACUNDO RIVERO - PIANO GUAGUANCO
 FELIX DEL ROSARIO - ESPERA
 Familia Valera Miranda - Choncholi Se Va Pa'l Monte
 Faustino Oramas - Cuidao Con El Perro
 GILBERTO Y SU CHARANGA - RITMO SABROSO
 GRUPO NICHE - CONSEJO DE MADRE
 HECTOR RAMOS EL GALAN DE LA SALSA - LA OTRA
 HERIBERTO Y SU SAOCO - A PETICION
 ISMAEL RIVERA CON RAFAEL CORTIJO Y SU COMBO - EL QUE NO SUFRE NO VIVE
 KIRRY JIMENEZ Y SU ORQUESTA - VACILA CON ELLA
 LES SUPERS JAGUARS - TATALIBABA
 LINDA LEYVA - DAME TU CORAZON
 LOS 5 DE ORO - EN EL BAJIO
 LOS 5 DE ORO - PALO DE MANGO
 LOS RIBEREÑOS - SILBANDO
 LOS SOLISTAS - MOSAICO No. 1
 LUCHA VILLA - FALSARIA
 NELSON Y SUS ESTRELLAS - SOL DE LA MAÑNA
 OUR LATIN GROOVE - GIRA Y GIRA
 PIO LEYVA - CARIÑOSO SI, MENTIROSO NO
 SANTIAGO CERON - LINDO YAMBU
 THE ALEGRE ALL STARS - AY CAMINA Y VEN
 THE SPANISH HARLEM ORCHESTRA - LA HIJA DE LOLA
 TITO RODRIGUEZ AND HIS ORCHESTRA - UN PATO
 WILLIE COLON - LA MURGA
 YIMBOLA COMBO - CONTIGO Y AQUI
